%%%%%%%%%%%%%%%%%
%             . %
%  .   %%%      %
%      % %      %
%      % %      %
%      % %..    %
%    %%% %%%    %
%    %G  G %    %
%    %%%%%%%    %
%P        .     %
%%%%%%%%%%%%%%%%%
